5 8
# # 2 3 S 3 2 1
1 1 # 2 1 # # 2
3 # # 3 1 2 3 1
E 2 3 1 2 # # #
2 3 # # # # # #